00 00 00 00 00 00 00 00 00 00 00 00 00 00 00 00 00 00 00 00 00 00 00 00 00 00 00 00 00 00 00 00 06 00 06 00 06 00 00 00 00 00 00 00 00 00 00 00 00 00 00 00 00 00 00 00 00 00 00 00 00
00 00 00 00 00 00 00 00 00 00 00 00 00 00 00 00 00 00 00 00 00 00 00 00 00 00 00 00 00 00 00 06 00 06 00 06 00 06 00 00 00 00 00 00 00 00 00 00 00 00 00 00 00 00 00 00 00 00 00 00 00
00 00 00 00 00 00 00 00 00 00 00 00 00 00 00 00 00 00 00 00 00 00 00 00 06 00 00 00 00 00 00 03 03 03 03 03 03 03 00 00 00 00 00 00 06 00 00 00 00 00 00 00 00 00 00 00 00 00 00 00 00
00 00 00 00 00 00 00 00 00 00 00 00 00 00 00 00 00 00 00 00 00 00 00 06 00 06 00 00 00 00 00 00 03 03 00 03 03 00 00 00 10 00 00 06 00 06 00 00 00 00 00 00 00 00 00 00 00 00 00 00 00
00 00 00 00 00 00 00 00 00 00 00 00 00 00 00 00 00 00 00 00 00 00 00 00 06 00 00 03 03 03 00 00 00 03 03 03 00 00 00 03 03 03 00 00 06 00 00 00 00 00 00 00 00 00 00 00 00 00 00 00 00
00 00 06 00 00 00 00 00 00 00 00 00 00 00 00 00 00 00 00 00 00 00 00 00 00 00 00 00 00 00 00 00 00 00 03 00 00 00 00 00 00 00 00 00 00 00 00 00 00 00 00 00 00 00 00 00 00 00 00 00 00
00 06 06 06 00 00 00 00 00 00 00 00 00 00 00 00 00 00 00 00 00 00 00 03 03 03 00 00 00 00 00 00 00 00 03 00 00 00 00 00 00 00 00 03 03 03 00 00 00 00 00 00 00 00 00 00 00 00 00 00 00
00 00 06 00 00 00 00 00 00 00 00 00 00 00 00 00 00 00 00 00 00 00 00 00 00 00 00 00 00 00 00 00 10 03 03 03 10 00 00 00 00 00 00 00 00 00 00 00 00 00 00 00 00 00 00 00 00 00 00 00 00
00 00 00 00 00 00 00 00 00 00 00 00 00 00 00 00 00 00 03 03 03 00 00 00 00 00 00 00 00 00 00 03 03 03 00 03 03 03 00 00 00 00 00 00 00 00 00 00 03 03 03 00 00 00 00 00 00 00 00 00 00
00 00 28 00 00 26 00 00 26 17 00 00 00 00 00 00 00 00 00 00 00 00 00 00 00 00 00 00 00 03 03 03 00 00 00 00 00 03 03 03 00 00 00 00 00 00 00 00 00 00 00 00 28 00 00 17 00 00 00 04 00
13 13 13 13 13 13 13 13 13 13 13 13 13 13 13 13 13 14 00 00 00 00 00 00 00 00 00 00 03 03 00 00 00 00 00 00 00 00 00 03 03 00 00 00 00 00 00 00 00 00 00 12 13 13 13 13 13 13 13 13 13
24 24 24 24 24 24 24 24 24 24 24 24 24 24 24 24 24 25 00 00 00 03 00 00 00 00 00 00 03 00 00 00 00 00 00 00 00 00 00 00 03 00 00 00 00 00 00 03 00 00 00 23 24 24 24 24 24 24 24 24 24
24 24 24 24 24 24 24 24 24 24 24 24 24 24 24 24 24 25 00 00 00 00 00 03 00 00 00 03 03 00 00 00 00 00 00 00 00 00 00 00 03 03 00 00 00 03 00 00 00 00 00 23 24 24 24 24 24 24 24 24 24
24 24 24 24 24 24 24 24 24 24 24 24 24 24 24 24 24 25 00 00 00 00 00 00 00 03 00 03 00 00 00 00 00 00 00 00 00 00 00 00 00 03 00 03 00 00 00 00 00 00 00 23 24 24 24 24 24 24 24 24 24
24 24 24 24 24 24 24 24 24 24 24 24 24 24 24 24 24 25 00 00 00 00 00 00 00 00 00 03 00 00 00 00 00 00 00 00 00 00 00 00 00 03 00 00 00 00 00 00 00 00 00 23 24 24 24 24 24 24 24 24 24