03 05 05 00 00 00 00 00 00 00 00 00 00 00 00 00 00 09 09 04
03 06 06 00 00 00 00 00 00 00 00 00 00 00 00 00 00 10 10 04
03 07 07 00 00 00 00 00 00 00 00 00 00 00 00 00 00 11 11 04
03 08 08 00 00 00 00 00 00 00 00 00 00 00 00 00 00 12 12 04
03 14 14 00 00 00 00 00 00 00 00 00 00 00 00 00 00 13 13 04
03 99 99 00 00 00 00 01 00 00 00 00 00 00 00 00 00 99 99 04
03 00 00 00 00 00 00 01 00 00 00 00 00 00 00 00 00 00 00 04
03 00 00 00 00 00 00 01 00 00 00 00 00 00 00 00 00 00 00 04
02 00 00 00 00 00 00 01 00 00 00 00 00 01 00 00 00 00 00 02
02 00 00 00 00 00 00 00 00 00 00 00 00 00 00 00 00 00 00 02
01 01 01 01 01 01 01 01 01 01 01 01 01 01 01 01 01 01 01 01